{
  "學": "학",
  "校": "교",
  "國": "국",
  "民": "민",
  "主": "주",
  "義": "의",
  "經": "경",
  "濟": "제",
  "新": "신",
  "聞": "문",
  "政": "정",
  "府": "부",
  "法": "법",
  "院": "원",
  "議": "의",
  "忠": "충",
  "孝": "효",
  "德": "덕",
  "信": "신",
  "智": "지",
  "勇": "용",
  "禮": "예",
  "仁": "인",
  "愛": "애",
  "敬": "경",
  "憲": "헌",
  "統": "통",
  "領": "령",
  "市": "가",
  "區": "가",
  "郡": "가",
  "道": "가",
  "省": "가",
  "縣": "가",
  "京": "가",
  "南": "가",
  "北": "가",
  "中": "가",
  "東": "가",
  "西": "가",
  "大": "가",
  "小": "가",
  "高": "고",
  "低": "가",
  "金": "김",
  "李": "이",
  "朴": "박",
  "崔": "최",
  "鄭": "정",
  "姜": "강",
  "趙": "조",
  "張": "장",
  "林": "림",
  "宋": "송",
  "許": "허",
  "韓": "한",
  "曹": "조",
  "曺": "조",
  "尹": "윤",
  "安": "안",
  "吳": "오",
  "徐": "서",
  "呉": "오",
  "馬": "마",
  "方": "방",
  "白": "백",
  "洪": "홍",
  "裵": "배",
  "柳": "유",
  "賈": "가",
  "成": "성",
  "卓": "탁",
  "丁": "정",
  "全": "전",
  "權": "권",
  "李": "이",
  "林": "임",
  "金": "김",
  "盧": "노",
  "疫": "역",
  "病": "병",
  "療": "료",
  "防": "방",
  "健": "건",
  "康": "강",
  "醫": "의",
  "藥": "약",
  "處": "처",
  "策": "책",
  "選": "선",
  "舉": "거",
  "軍": "군",
  "兵": "병",
  "戰": "전",
  "爭": "쟁",
  "和": "화",
  "平": "평",
  "交": "교",
  "通": "통",
  "港": "항",
  "電": "전",
  "話": "화",
  "機": "기",
  "車": "차",
  "飛": "비",
  "場": "장",
  "空": "공",
  "公": "공",
  "共": "공",
  "私": "사",
  "務": "무",
  "職": "직",
  "業": "업",
  "工": "공",
  "商": "상",
  "農": "농",
  "水": "수",
  "火": "화",
  "土": "토",
  "木": "목",
  "家": "가",
  "族": "족",
  "親": "친",
  "父": "부",
  "母": "모",
  "男": "남",
  "女": "여",
  "子": "자",
  "兄": "형",
  "弟": "제",
  "姉": "자",
  "妹": "매",
  "婚": "혼",
  "育": "육",
  "生": "생",
  "死": "사",
  "老": "노",
  "恨": "한",
  "悲": "비",
  "怒": "노",
  "喜": "희",
  "樂": "악",
  "夢": "몽",
  "心": "심",
  "身": "신",
  "體": "체",
  "力": "력",
  "氣": "기"
}